[10,10]
(1,7)
(7,4)
(0,6,1,1)
(1,6,1,1)
(2,7,1,1)
(2,6,1,1)
(0,7,1,1)
(0,8,1,1)
(2,8,1,1)
(1,8,1,1)