[10,10]
(1,4)
(7,1) | (7,7)
(4,1,1,1)
(4,2,1,1)
(4,3,1,1)
(4,4,1,1)
(4,6,1,1)
(4,7,1,1)
(4,8,1,1)
(5,8,1,1)