[10,10]
(1,5)
(6,2) | (8,4)
(9,1,1,1)
(8,1,1,1)
(7,1,1,1)
(6,1,1,1)
(5,1,1,1)
(4,1,1,1)
(4,2,1,1)
(4,3,1,1)
(4,4,1,1)
(4,5,1,1)
(5,5,1,1)
(6,5,1,1)
(7,5,1,1)
(8,5,1,1)
(9,5,1,1)