[10,5]
(4,0)
(4,9)
(4,8,1,1)
(3,8,1,1)
(2,8,1,1)
(1,8,1,1)
(1,6,1,1)
(1,7,1,1)
(3,1,1,1)
(2,3,1,1)
(1,3,1,1)
(0,3,1,1)
(3,5,1,1)
(3,6,1,1)
(3,7,1,1)
(2,2,1,1)
(2,1,1,1)
(3,3,1,1)
(1,5,1,1)
(1,1,1,1)
(0,1,1,1)