[10,10]
(5,0)
(3,8)
(3,6,1,1)
(4,6,1,1)
(5,6,1,1)
(6,6,1,1)
(7,6,1,1)
(8,6,1,1)
(9,6,1,1)
(2,6,1,1)
(2,5,1,1)
(2,4,1,1)
(2,3,1,1)
(2,2,1,1)
(4,0,1,1)
(4,1,1,1)
(5,1,1,1)
(6,1,1,1)
(7,1,1,1)
(7,2,1,1)