[10,10]
(3,5)
(6,5)
(3,4,1,1)
(4,4,1,1)
(5,4,1,1)
(6,4,1,1)
(3,6,1,1)
(4,6,1,1)
(5,6,1,1)
(6,6,1,1)
(1,1,1,1)
(6,1,1,1)
(8,3,1,1)
(8,7,1,1)
(5,8,1,1)
(1,8,1,1)